#		Config des paroles du Rotobservatoire


lang fr ~
lang en #

parole tropnombreux	o
parole modeemploi	p
parole bonjour		q

parole point1	a	E	
parole point2	z	SE
parole point3	e	S
parole point4	r	SO
parole point5	t	O
parole point6	y	NO
parole point7	u	N
parole point8	i	NE

parole pointB1	a	E	
parole pointB2	z	SE
parole pointB3	e	S
parole pointB4	r	SO
parole pointB5	t	O
parole pointB6	y	NO
parole pointB7	u	N
parole pointB8	i	NE

parole pointC1	a	E	
parole pointC2	z	SE
parole pointC3	e	S
parole pointC4	r	SO
parole pointC5	t	O
parole pointC6	y	NO
parole pointC7	u	N
parole pointC8	i	NE


